##c##ccc#
##ccc####
#########
####B####
##p###-####
#########
ccccccccccccccccccccccccccccccccccc
#########
####_####
#########
ccccccccc